########
#OO    #
# @    #
#      #
#A   ###
# @    #
#      #
########
