#######
#O    #
#O@   #
# @   #
#A    #
#     #
#######
