########
#O   ###
#O    ##
# @    #
#A  ####
# @    #
#      #
########